 ###
 #.###
##$#.#
#.$@$##
###$$.#
  #.###
  ###