       ###
      ##@#
####### $#
#    # $.#
# ##  $.####
#$ ###.###.#
#.$ #####.$#
##.$   #.$ #
 ##.## #$ ##
  #### # ##
     #   #
     #####