#######
#     ####
# #$# #  #
# .@.    #
# #$###  #
#       ##
#########