   ########
   #      #
   # $$$$ #
#### $  $ #
#..# # $$ #
#... # $  #
#..  #@$  #
##. . #$  #
 ##..    ##
  #.###$##
  #     #
  #######