##########
#        #
# $ $$#$ #
# #    $ #
#  ####$##
#   ...  #
##$#.#.# #
# $ ...# #
# #  #   #
#@    ####
###   #
  #####